Track: Heaven

Lyrics:
2 ContributorsNew Music Friday 2/12/21 LyricsNipsey Hussle - What It Feels Like
Dua Lipa - We're Good
KAROL G - LOCATION
Pink Sweat$ - Heaven
Taylor Swift - Love Story (Taylor‚Äôs Version)
Lil Tjay - Calling My Phone
Erica Banks - Buss It (feat. Travis Scott)
Lucky Daye - How Much Can A Heart Take (feat. Yebba)
Pale Waves - Fall to Pieces
Surf Mesa - Carried Away (with Madison Beer)
Rita Ora - Big (feat. Gunna)
P!nk - Cover Me In Sunshine
Florida Georgia Line - Always Gonna Love You
Young Stoner Life - That Go! (feat. T Shyne)
A$AP Rocky - Rich Nigga Problems
slowthai - terms (feat. Dominic Fike & Denzel Curry)
Gryffin - I Want Love (with Two Feet)
Leah Nob–µl - Beginning Middle End - From The N–µtflix Film "To All The Boys: Always and Forever"
Alaina Castillo - stfu (i got u)
Sara Kays - Future Kids
Ruel - too many feelings
Quinn XCII - My Wife & 2 Dogs
Lil Mosey - Enough
G-Eazy - A Little More (feat. Kiana Led√©)
Sia - 1+1
Ashe - The Same
Kodak Black - Every Balmain
Headie One - Siberia (feat. Burna Boy)
Rowdy Rebel - Jesse Owens (feat. NAV)
Rebecca Black - Friday (Remix)
Maude Latour - Walk Backwards
Valley - Like 1999
Lucy Park - True to You
Syd - Missing Out
Kelly Rowland - Black Magic
Clever - Rolls Royce Umbrella
lilspirit - 4ever
Claud - Guard Down
Patrick Droney - Yours in the Morning
Ryan Hurd - Chasing After You (with Maren Morris)
Francis Karel - You're Too Close
MOD SUN - Betterman
The Pretty Reckless - Only Love Can Save Me Now (feat. Matt Cameron & Kim Thayil)
BETWEEN FRIENDS - shiny
Kevin Gates - Plug Daughter 2
Smokepurpp - Prom Queen
Young M.A - Off the Yak
Sevyn Streeter - Guilty
PJ Harding - Dear August
Peach Tree Rascals - OOZ
Biig Piig - Cuenta Lo
Dan D'Lion - Need You Right Now (feat. Channel Tres) üêö
UPSAHL - STOP!
Tiera - Miles (feat. BRELAND) üêö
Evaluna Montaner - Uno M√°s Uno
Kings of Leon - Echoing
X Ambassadors - skip.that.party (with Jensen McRae)
Gallant - Relapse.
YBN Almighty Jay - Battling My Spirit
Guapdad 4000 - How Many
Babyface Ray - Allowance (feat. Kash Doll)
Young Devyn - Straight To It
Charlie Heat - Angry Hearts
Zachary Knowles - johnny & june
Hauskey - Go Wrong
Sports - Call Me Anytime
ROSIE - Retail Therapy
Emmit Fenn - Until We Leave the Ground
Moore Kismet - Rumor üêö
Curbi - Make Amends (feat. Kyan Palmer)
Pentatonix - Coffee In Bed
Robin Thicke - Look Easy
Eric Bellinger - Hype Beast
JPEGMAFIA - PANIC ROOM!
Doe Boy - Low Key (feat. Lil Uzi Vert)
Shy Glizzy - White Lie (feat. RMR)
Greta Van Fleet - Heat Above
COIN - Sagittarius Superstar (feat. Faye Webster)
Jon Foreman - A Place Called Earth
Jamie Miller - Hold You 'Til We‚Äôre Old
TOLEDO - Sunday Funday
Dylan Fraser - Gucci Sweater
Boslen - TRIP
LPB Poody - Batman üêö
Lil Muk - Living Life (feat. Lil Baby & YXNG K.A.)
Phora - colorblind
Ouse - Why Did You Tell Me That You Loved Me?
Christian Leave - Filth
Rileyy Lanez - When I See You (Lamont's Song)
Jacob Banks - Parade
Briston Maroney - It's Still Cool If You Don't
Sir Sly - Loverboy
Beanz - Trending Topic
Marlon Craft - Lookin Up
Fuego - Pal De Pesos
Morgan Wade - Take Me Away üêö
Djouher - Patience
Savannah Cristina - Body Work
Tayo Sound - Runaway
Michael Brun - Oh MamaEmbed
